0 0 0 0 0 0 0 0 0 0 0 0 0 0 0 0 0 0 0 0
0 0 0 0 0 0 0 0 0 0 0 0 0 0 0 0 0 0 0 0
0 0 0 0 0 0 0 0 0 0 0 0 0 0 0 0 0 0 0 0 
0 0 1 1 1 0 0 1 1 1 1 1 1 1 1 1 1 1 1 1 
0 1 1 4 1 1 1 1 5 5 5 5 5 5 5 1 5 5 5 1
0 1 5 3 3 5 5 5 3 3 5 5 3 5 3 5 2 2 2 1
0 1 5 5 3 3 3 1 5 5 5 5 3 5 5 1 2 2 2 1
0 1 5 3 5 5 5 1 5 3 3 5 3 3 5 1 2 2 2 1
0 1 1 1 5 5 5 1 5 5 3 5 5 5 5 1 2 2 2 1
0 1 5 5 5 5 5 1 5 3 5 3 5 3 5 1 2 2 2 1
0 1 5 5 5 5 1 1 1 1 1 1 5 1 1 1 2 2 2 1
0 1 1 5 1 5 5 1 5 5 3 5 3 5 5 1 2 2 2 1
0 1 5 5 1 1 5 1 5 3 3 5 3 5 3 1 1 2 2 1
0 1 5 2 2 1 5 1 5 5 3 5 5 5 5 5 5 1 2 1
0 1 5 2 2 1 5 1 5 3 3 3 5 3 3 3 5 1 2 1
0 1 1 1 1 1 5 1 5 5 5 5 5 5 5 1 5 1 2 1
0 0 0 0 0 1 5 1 1 1 1 1 1 1 1 1 5 1 2 1 
0 0 0 0 0 1 5 5 5 5 5 5 5 5 5 5 5 1 2 1
0 0 0 0 0 1 1 1 1 1 1 1 1 1 1 1 1 1 1 1
0 0 0 0 0 0 0 0 0 0 0 0 0 0 0 0 0 0 0 0




